000000000000000
000000000000000
000000000000000
000000000000000
000000111111113
000000100000000
000000100000000
211111100000000
000000000000000
000000000000000
