000000000000400
002200000040000
002200330000040
000000000000000
000400111111119
040000100000000
000000100000330
811111100002240
000000000402200
